..............................................................
..............................................................
..............................................................
..............................................................
..............................................................
..............................................................
..............................................................
..............................................................
..................................V.S.........................
................................######........................
..............................................................
.......................QL...C.............Q.!.................
......................######..............######..............
..............................................................
..............V.H.........................................O...
............######...............................>............
.P........<.........................................##########
########^^^^......^^^^......^^^^......^^^^......^^^^..........