......................................................
......................................................
......................................................
......................................................
......................................................
......................................................
......................................................
......................................................
......................................................
..............................E.ES....................
...........................########...................
...................E.ES...............Q..E.ES.........
................########..............########........
........E.ES..........................................
.....########.........................................
..................................................O...
.P.............!..........LC.........!........L######.
#############^^^########^^^########^^^################