..............................................................
..............................................................
..............................................................
..............................................................
..............................................................
..............................................................
..............................................................
..............................................................
...................................LHQ........................
................................######........................
..............................................................
.........................V..C..............Q.V................
......................######..............######..............
..............................................................
.............!.S..........................................O...
............######................................>...........
.P.........<........................................##########
########^^^^......^^^^......^^^^......^^^^......^^^^..........