..............................................................
..............................................................
..............................................................
..............................................................
..............................................................
..............................................................
..............................................................
..............................................................
...................................LH.........................
................................######........................
..............................................................
.........................V..C................V................
......................######..............######..............
..............................................................
.............!.S.Q........................................O...
............######................................>.Q.........
.P.........<........................................##########
########^^^^......^^^^......^^^^......^^^^......^^^^..........