..............................................
..............................................
..............................................
..............................................
..............................................
..............................................
..............................................
..............................................
..............................................
..............................................
..............................................
..............................................
....................Q...######................
...............######.........................
.................................#####........
......######..............................O...
.P....................................#######.
#############^^######^^#######^^##############