......................................................
......................................................
......................................................
......................................................
......................................................
......................................................
......................................................
......................................................
......................................................
......................................................
.............................Q.E.S....................
............................#######...................
....................E.S...................E.S.........
.................#######...............#######........
.........E.S..........................................
......#######.....................................O...
.P............!............LC.......!.........L######.
#############^^^^#######^^^^#######^^^^###############