..............................................
..............................................
..............................................
..............................................
..............................................
..............................................
..............................................
..............................................
.................Q..................E.........
.................###...............###........
.........S.................S..................
........###...............###.................
..............................................
..............................................
..............................................
......######...######...######...######...O...
.P............!........C.L...........!..#####.
############^^#######^^#######^^#######^######