..............................................
..............................................
..............................................
..............................................
..............................................
..............................................
..............................................
..............................................
........................####..................
................E.............................
..............####...............S............
................................####..........
........Q.....................................
......####....................................
..............................................
..........................................O...
.P.......................C.............######.
#########^^^#######^^^.#######^^^.############