..............................................................
..............................................................
..............................................................
..............................................................
..............................................................
..............................................................
..............................................................
..............................................................
...................................LHQ.H......................
................................######........................
............................BBBB..............................
.......................!.V..C..........R..Q..VQQ..............
......................######..............######..............
..............................................................
.............!.S..BBBB....................................O...
............######................................>...........
.P.........<........................................##########
########^^^^......^^^^......^^^^......^^^^......^^^^..........