............................................................
............................................................
............................................................
............................................................
............................................................
............................................................
............................................................
............................................................
............................................................
............................................................
............................................................
............................................................
....................Q...######..............................
...............######.......................................
.................................#####......................
......######..............................O.................
.P....................................#######...............
#############^^######^^#######^^##############..............