..............................................................
..............................................................
.....R........................................................
..............................................................
..............................................................
..................................CV.H........................
.................................######.......................
..............................................................
..............................................................
.........................L..Q...............QL.S..............
.......................######..............######.............
..............................................................
..............................................................
.............Q.V.H............................................
.............######.......................................O...
....................................................>..V......
.P........<..........................................#########
#########^^^^......^^^^......^^^^......^^^^......^^^^.........