..............................................................
..............................................................
..............................................................
..............................................................
..............................................................
..............................................................
..............................................................
..............................................................
................................N.V.S..HV.....................
................................######........................
............................BBBB..............................
.......................!H...C.L...........QQ!.SQ..............
......................######..............######..............
...................Q..........................................
..............V.H.BBVB....................................O...
............######...............................>..Q.H.!.....
.P..S.!...<.........................................##########
########^^^^......^^^^......^^^^......^^^^......^^^^..........