............................................................
............................................................
............................................................
............................................................
...........................EQ...............................
..........................BBB...............................
............................................................
............................................................
................S......................S....................
...............BBB....................BBB...................
............................................................
............................................................
............................................................
.......BBB.....................................BBBB.........
............................................................
...................................................O........
.P........!............L..C........!..........L.............
#########^^^#########^^^#########^^^#########^^^######......