..............................................................
..............................................................
..............................................................
..............................................................
..............................................................
..............................................................
..............................................................
..............................................................
..................................V.S..HV.....................
................................######........................
............................BBBB..............................
.......................!L...C.L...........Q.!...T.............
......................######..............######..............
..............................................................
..............VQHQBBVB....................................O...
............######...............................>..Q.H.......
.P....!...<.........................................##########
########^^^^......^^^^......^^^^......^^^^......^^^^..........