............................................................
............................................................
............................................................
..................................................O.........
...............................................######.......
............................................................
.........................................E..................
.....................................RBBBBBB................
.................................S..........................
..............................######........................
.......................Q....................................
......................BBBBBBC...............................
.................E..........................................
..............######........................................
............................................................
......BBBBBB................................................
.P............!...........L...........!.......L.............
############^^######^^######^^######^^######^^^#######......