..............................................................
..............................................................
..............................................................
..............................................................
..............................................................
..............................................................
..............................................................
..............................................................
..................................QLH..HV.....................
................................######........................
............................BBBB......R.......................
.......................!.V..C.L.............QV................
......................######..............######..............
.....................Q........................................
.............!.SQ.BBVB....................................O...
............######................................>...H.......
.P....!....<........................................##########
########^^^^......^^^^......^^^^......^^^^......^^^^..........