............................................................
............................................................
............................................................
............................................................
............................................................
......................###...................................
............................................................
............................................................
..............S.................S...........................
.............###...............###..........................
............................................................
............................................................
......Q.....................................................
.....###...............................####.................
............................................................
...........................................O................
.P....................C.....................................
#######^^^#######^^^#######^^^#######^^^######..............