............................................................
............................................................
............................................................
............................................................
............................QSE.............................
............................BBBB............................
............................................................
............................................................
................QSE......................SEQ................
................BBBB....................BBBB................
............................................................
............................................................
.......Q....................................................
......BBBB......................................BBBB........
............................................................
...................................................O........
.P..........!...........L..C........!.........L.............
##########^^^#########^^^#########^^^#########^^^#####......